super + Return	ğŸ’»ï¸ launch terminal
super + p	ğŸš€ run dmenu
super + q	âŒ close window (method 1)
super + shift + c	âŒ close window (method 2)
super + ctrl + b	ğŸ‘€ toggle bar
super + tab	â®ï¸ last tag
super + right	â¡ï¸ go to tag to the right
super + left	â¬…ï¸ go to tag to the left
super + ctrl + right	â†ªï¸ move focused window to next tag
super + ctrl + left	â†©ï¸ move focused window to prev tag
super + k	ğŸ‘‰ï¸ focus next window
super + j	ğŸ‘ˆï¸ focus previous window
super + shift + k	â†ªï¸ move window right
super + shift + j	â†©ï¸ move window left
super + shift + l	ğŸ¤œ resize window right
super + shift + h	ğŸ¤› resize window left
super + shift + s	ğŸ“Œ toggle Sticky window
super + shift + space	ğŸ›Ÿ toggle floating
super + shift + r	â™»ï¸ restart dwm
super + ctrl + shift + q	ğŸšª quit dwm
